####################
E.......#.##......##
##.######....##.#.##
##.....##.##......##
##.....##.......#.##
##.#.######..####.##
##..#....##.....#.##
##.####..######.#.##
##...........##.#..#
##.##...####.##.#.##
##..........#...#.##
##.....##...##..#.##
##...##.#.#.....#.##
##.#.....##.....#.##
##.###.##.........##
##.....##.........##
##.......######.#.##
##.###.###.##.###.##
##..##........#...##
###############S####
