########################################
#...........................#...#......#
#.#.#.#.#.##.#.#.######.#.#...#.#.#.##.#
#.#.#####.##.#.#......#.#.#.#..........#
#.#...#.#.####.#.####.......##.#.#.###.#
#.######.....##.#......####.##.#.#.#.#.#
#.############.#.##########.##.#.###.#.#
#.#.......................#............#
#.##.##.#.#.#.#.#.#.#.#.#.#.###.#.#.##.#
#.#...#...#....#....#.....#.#.#...#.##.#
#.#.#######################.#.###.####.#
E.............#.......#.....#..........#
#############################S##########