########################################
S......##...........#......##.........##
##.....##.......#.#..#.....######...#.##
##.....##..####...#.##.....##.........##
##.....##...#####.#..#.....##...#####.##
##...######.....#.##.#...######.....#.##
##.......##.....#.#..#.......##.....#.##
##.......######.#.##.#.......######.#.##
##...........##.#..#.#.####......##.#..#
##.####.####.##.#.##.#......####.##.#.##
##..............#.#..#..............#.##
##.....##.......#.#.##.....##.......#.##
##...######.....#.#..#...######.....#.##
##.......##.....#.##.#.......##.....####
##.....##.........##.#.....##.........##
##.....##.........#..#.....##.........##
##.......######.#.#.##.......######.#.##
##.###.###.##.###.#..#.###.###.##.###.##
##..##........###.#.....##........###.##
#####################################..#
#......................................#
#.#########.############################
#......................................#
##########################.#############
#......................................#
##E#####################################
