#E################
#.####..##.....###
#....##....#.#..##
#....##...##..####
##.####.#...#...##
##...##.#.#..##.##
####.#.##..##...##
##...#....###.####
#...#####..#..####
#.#..##...##.#...#
##....#.####.#.#.#
#...#...####...#.S
##################
